**** *** *
    **  * 
 * * * ** 
 **  * ***
* ** *** *
*    * ***
* *   *  *
**  * * **
* *  *  **
*     *  *
