 ** **  * 
 * * *  * 
  *   *** 
* * * ****
 *  * **  
 *** * * *
*** ******
 *** ** * 
**  * **  
 ******  *
