*****   **
       ** 
  ****   *
 *** *  **
*   * * * 
  ***** * 
 *  **** *
* ** *** *
 ****   **
** **  * *
