*** ***
*   ***
* *****
* *****
* *****
*   ***
*** ***