   *****  
** * *    
 **     **
*  **  *  
***   * **
  ***  * *
 * **     
*  * * ***
*** ******
 *  ***   
