     **   
** ****** 
* * * * **
 * ****** 
 ****  * *
 * *  *** 
*** ** *  
**  *  ***
 ** ** * *
 ***** * *
