  **     *
* * ***  *
 *  *  ***
** *   * *
 ****  *  
 *** ***  
  *  **  *
**     * *
***** *   
*  * ***  
