          
  *    ***
* ** * ** 
**   ***  
* ****  * 
** *  **  
* *  * *  
   ****   
* ***    *
* **     *
