*  ** ****
** *  *  *
** * *** *
** *   ** 
*  ** *** 
** *** * *
   *   * *
*   * ****
 ******** 
  **** *  
