 * *** *  
*** **  * 
   **   **
*  **    *
   ****** 
  * *  *  
 **   *** 
** ** * * 
  *    * *
*   *   **
