****    **
** * * * *
 *    **  
 *      **
     **  *
* **  * * 
****** * *
  * *** * 
    * * **
** *  *  *
