 **  * *  
  ***  ***
**     *  
** ** * * 
    **    
**   **   
* *** * * 
** ***  **
    ***  *
* * ******
