 **      *
*** **  **
   **  ***
     * *  
* ** *  * 
 **  ** * 
 *** ** * 
       ** 
** *** ***
*  *    * 
