 *      * 
  * * * **
***** *** 
      ****
*** ***  *
**        
* * * *   
    *  * *
** * ** * 
**   *  **
