  * ***  *
 *  *** **
 ** *   * 
*  ** *  *
* *   **  
* ** *****
* **  ****
  *  *****
***   *** 
  ***   * 
