* *** * **
 * * * ** 
 *  **  * 
  **  *  *
*   **** *
 *  ** ** 
***    ** 
      * * 
 * *      
    * *** 
