* *** * **
*     ****
*  * *****
*  *      
*  * *****
**********
****   ***
****  ****
**   *****
**        